T T T T T T T T T T T T T T T T T T T T T T T T T T T T T T T T T T T T T T T T T T T T T T T T T T T T T T T T T T T T T T T T T T T T T T T T T T T T T T T T T T T T T T T T T T T T T T T T T T T T T T T
T T T T T T T T T T T T T T T T T T T T T T T T T T T T T T T T T T T T T T T T T T T T T T T T T T T T T T T T T T T T T T T T T T T T T T T T T T T T T T T T T T T T T T T T T T T T T T T T T T T T T T T
T T T T T T T T T T T T T T T T T T T T T T T T T T T T T T T T T T T T T T T T T T T T T T T T T T T T T T T T T T T T T T T T T T T T T T T T T T T T T T T T T T T T T T T T T T T T T T T T T T T T T T T
T T T T T T T T T T T T T T T T T T T T T T T T T T T T T T T T T T T T T T T T T T T T T T T T T T T T T T T T T T T T T T T T T T T T T T T T T T T T T T T T T T T T T T T T T T T T T T T T T T T T T T T
T T T T T T T T T T T T T T T T T T T T T T T T T T T T T T T T T T T T T T T T T T T T T T T T T T T T T T T T T T T T T T T T T T T T T T T T T T T T T T T T T T T T T T T T T T T T T T T T T T T T T T T
T T T T T T T T T T T T T T T T T T T T T T T T T T T T T T T T T T T T T T T T T T T T T T T T T T T T T T T T T T T T T T T T T T T T T T T T T T T T T T T T T T T T T T T T T T T T T T T T T T T T T T T
T T T T T T T T T T T T T T T T T T T T T T T T T T T T T T T T T T T T T T T T T T T T T T T T T T T T T T T T T T T T T T T T T T T T T T T T T T T T T T T T T T T T T T T T T T T T T T T T T T T T T T T
T T T T T T T T T T T T T T T T T T T T T T T T T T T T T T T T T T T T T T T T T T T T T T T T T T T T T T T T T T T T T T T T T T T T T T T T T T T T T T T T T T T T T T T T T T T T T T T T T T T T T T T
T T T T T T T T T T T T T T T T T T T T T T T T T T T T T T T T T T T T T T T T T T T T T T T T T T T T T T T T T T T T T T T T T T T T T T T T T T T T T T T T T T T T T T T T T T T T T T T T T T T T T T T
T T T T T T T T T T T T T T T T T T T T T T T T T T T T T T T T T T T T T T T T T T T T T T T T T T T T T T T T T T T T T T T T T T T T T T T T T T T T T T T T T T T T T T T T T T T T T T T T T T T T T T T
T T T T T T T T T T T T T T T T T T T T T T T T T T T T T T T T T T T T T T T T T T T T T T T T T T T T T T T T T T T T T T T T T T T T T T T T T T T T T T T T T T T T T T T T T T T T T T T T T T T T T T T
T T T T T T T T T T _ _ G _ _ _ _ _ _ _ _ _ _ _ _ _ _ _ _ _ _ _ _ G G G G G G G G G G _ _ _ _ _ _ _ _ _ _ _ _ T T T T T T T T T T T T T T T T T T T T T T T T T T T T T T T T T T T T T T T T T T T T T T T T
T T T T T T T T T T _ G G G _ _ _ _ _ _ _ _ _ _ _ _ _ _ _ _ _ _ _ G G G G G G G G G G G G G _ _ G B B B B B _ T T T T T T T T T T T T T T T T T T T T T T T T T T T T T T T T T T T T T T T T T T T T T T T T
T T T T T T T T T T G G B G G _ _ _ _ _ _ _ _ T T T B B B B B B B B B B B B G G G G G G G G G G G B B B B B _ T T T T T T T T T T T T T T T T T T T T T T T T T T T T T T T T T T T T T T T T T T T T T T T T
T T T T T T T T T T _ G G G _ W W W W W W W W T T T _ _ _ _ _ _ _ _ _ _ _ _ _ G G G G G G G G G G B B d B B _ T T T T T T T T T T T T T T T T T T T T T T T T T T T T T T T T T T T T T T T T T T T T T T T T
T T T T T T T T T T _ _ G _ _ W W W W W W W W T T T _ _ _ _ _ _ _ _ _ _ _ _ _ _ _ _ G G G G G _ _ _ _ _ _ _ _ T T T T T T T T T T T T T T T T T T T T T T T T T T T T T T T T T T T T T T T T T T T T T T T T
T T T T T T T T T T T _ _ _ _ W W W W W W W W W W W _ _ _ _ _ _ T T T B B B B B B B B B B B B _ _ _ _ _ _ _ _ T T T T T T T T T T T T T T T T T T T T T T T T T T T T T T T T T T T T T T T T T T T T T T T T
T T T T T T T T T T T _ _ _ _ W W W W W W W W W W W _ _ G G G G T T T _ _ _ _ _ _ _ _ _ _ _ M m m m m m m m M T T T T T T T T T T T T T T T T T T T T T T T T T T T T T T T T T T T T T T T T T T T T T T T T
T T T T T T T T T T T _ _ _ W W W W W W G G G G G G G G G G G _ T T T _ _ _ _ _ _ _ _ _ _ _ M m m m m m m m M T T T T T T T T T T T T T T T T T T T T T T T T T T T T T T T T T T T T T T T T T T T T T T T T
T T T T T T T T T T T _ _ _ W W W W W W G G G G G G G G G G _ _ B _ _ _ _ _ _ _ _ _ _ _ _ _ M m m m m m m m M T T T T T T T T T T T T T T T T T T T T T T T T T T T T T T T T T T T T T T T T T T T T T T T T
T T T T T T T T T T T W W W _ _ _ _ _ _ _ _ _ _ G G G G G _ _ _ B _ _ _ _ _ _ _ _ _ _ _ _ _ M M s s M M m m M T T T T T T T T T T T T * * * * * * * * T T T T T T T T T T T T T T T T T T T T T T T T T T T T
T T T T T T T T T T T W W W _ _ _ _ _ _ _ _ _ _ _ _ G G _ _ _ _ B _ _ _ _ _ _ _ _ _ _ _ _ _ _ _ _ _ _ M m m M T T T T T T T T T T T T * Z O N E - 2 * T T T T T T T T T T T T T T T T T T T T T T T T T T T T
T T T T T T T T T T T W W W _ _ _ _ _ _ _ _ _ _ _ _ _ _ _ _ M m m m m m m m m m M _ _ _ _ _ _ _ _ _ _ M m m M T T T T T T T T T T T T * * * * * * * * T T T T T T T T T T T T T T T T T T T T T T T T T T T T
T T T T T T T T T T T W W W _ _ _ _ G G G G G G _ _ _ _ _ _ M m m m m m m m m m M _ _ _ _ _ _ _ _ _ _ M m m M T T T T T T T T T T T T T T T T T T T T T T T T T T T T T T T T T T T T T T T T T T T T T T T T
T T T T T T T T T T T W W W _ G G G G G G G G G G G _ _ _ _ M m m m m M M s s M M M m m m m m m m m m m m m M T T T T T T T T T T T T T T T T T T T T T T T T T T T T T T T T T T T T T T T T T T T T T T T T
T T T T T T T T T T T T B _ G G G G G G G G G G G G G G G _ M m m m m M G G G G G M m m m m m m m m m m m m M T T T T T T T T T T T T T T T T T T T T T T T T T T T T T T T T T T T T T T T T T T T T T T T T
T T T T T T T T T T T T B G G G G G G G G G G G G G G G G _ M m m m m M G G G G G M m m m m m m m m m m m m M T T T T T T T T T T T T T T T T T T T T T T T T T T T T T T T T T T T T T T T T T T T T T T T T
T T T T T T T T T T T T B G G W W W W W W W W W W W W W G G M s s M M M G G G G G M M M s s M M M M M M M M M T T T T T T T T T T T T T T T T T T T T T T T T T T T T T T T T T T T T T T T T T T T T T T T T
T T T T T T T T T T T T B G G W W W W W W W W W W W W W G G _ _ _ B G G G G G G G R _ _ _ _ _ _ _ _ _ _ _ _ _ T T T _ _ _ _ _ _ _ _ _ _ G G G G G G G G G G G G G G G G _ _ _ G G G G G _ T T T T T T T T T T
T T T T T T T T T T T R R G G W W W W W W W W W W W W W G _ _ _ _ B G G G G G G G _ _ _ _ _ _ _ _ _ _ _ _ _ _ T T T _ _ _ _ _ _ _ _ _ _ G G G G G G G G G G G G G G _ _ _ _ G G G G G G G T T T T T T T T T T
T T T T T T T T T T T R R G G W W W W W W W W _ _ _ _ _ _ _ _ _ _ B G G G G G G G G G _ _ _ _ _ _ _ _ _ _ _ _ E E E B B B B B B B B _ _ _ _ G G G G G G G G G G _ _ _ _ _ G G G G G G G G T T T T T T T T T T
T T T T T T T T T T T E G G G W W W W W W W W _ _ _ _ _ _ _ _ _ _ B _ _ G G G G G G G G _ _ _ _ _ _ _ _ _ _ _ _ _ _ _ _ _ _ _ _ _ _ _ _ _ _ M m m m m m m m m m m m M G G G G G G G G G G T T T T T T T T T T
T T T T T T T T T T T E G G G G G G _ _ _ _ _ _ _ _ _ _ _ _ _ _ _ B _ _ G G G G G G G G _ _ _ _ _ _ _ _ _ _ _ _ _ _ _ _ _ _ _ _ _ _ _ _ _ _ M m m m m m m m m m m m M G G G G G G G G G G T T T T T T T T T T
T T T T T T T T T T T E _ G G G G _ _ _ _ _ _ _ _ _ _ _ _ _ _ _ _ E _ _ _ _ _ G G G _ _ _ _ _ _ _ _ _ _ _ _ _ E E E E E B B B B B B B B B B M m m m m m m m m m m m M _ G G G B B B B B G T T T T T T T T T T
T T T T T T T T T T T E _ _ _ _ _ _ _ _ _ _ _ _ _ _ _ _ _ _ _ _ _ E _ _ _ _ _ G G G _ _ _ _ _ _ _ _ _ _ _ _ _ T T T T T _ _ _ _ _ _ _ _ _ _ M M s s M M M M M s s M M G G G G B B B B B G T T T T T T T T T T
T T T T T T T T T T E _ E E _ _ E T T T T T T T T T T T T T T T T E E E _ _ _ E _ _ _ _ _ _ _ _ _ _ _ _ _ _ _ T T T T T _ _ _ G _ _ _ _ G _ _ _ _ _ _ R R _ _ _ _ _ _ _ G G _ B B B B B _ T T T T T T T T T T
T T T T T T T T T T T T T E _ _ E T T T T T T T T T T T T T T T T T T E _ _ _ E T T T T T T T T T T T T T T T T T T T T _ _ G G _ _ _ _ G G _ _ _ _ _ R R _ _ _ _ _ _ _ _ _ _ B d B B B _ T T T T T T T T T T
T T T T T T T T T T T T T E _ _ E T T T T T T T T T T T T T T T T T T E _ _ _ E T T T T T T T T T T T T T T T T T T T T _ G G G _ G G _ G G G _ _ _ W W W W W W W W W W _ _ _ _ _ _ _ _ _ T T T T T T T T T T
T T T T T T T T T T T T T E _ _ E T T T T T T T T T T T T T T T T T T E _ _ _ E T T T T T T T T T T T T T T T T T T T T G _ _ _ G G G G _ _ _ _ _ _ W W W W W W W W W W _ _ _ _ _ _ _ _ _ T T T T T T T T T T
T T T T T T T T T T T T T T T T T T T T _ _ _ _ _ _ _ _ _ _ _ _ _ B _ _ _ _ _ _ _ _ _ _ _ _ _ _ _ _ _ _ _ _ _ T T T T T G _ _ G G G G G G _ _ _ _ _ W W W W W W W W W M m m m m m m m m M T T T T T T T T T T
T T T T T T T T T T T T T T T T T T T T _ _ _ _ _ _ _ _ _ _ _ _ _ B _ _ _ _ _ _ _ _ _ G G G G G _ _ _ _ _ _ _ T T T T T G _ _ G G G G G G _ _ _ _ G G G G G G G G G W M m m m m m m m m M T T T T T T T T T T
T T T T T T T T T T T T T T T T T T T T _ _ _ _ _ G G G G _ _ _ _ B _ _ _ _ _ G G G G G G G G G G G _ _ _ _ _ T T T T T G _ _ _ G G G G _ _ _ _ _ G G G G G G G G G W M M m m M s s M M M T T T T T T T T T T
T T T T T T T T T T T T T T T T T T T T _ _ _ G G G G G G G G _ _ B _ _ _ _ G G G G G G G G G G G G G _ _ _ _ T T T T T _ G G G _ G G _ G G G _ _ _ W W W W W W W W W W M m m M _ _ _ _ _ T T T T T T T T T T
T T T T T T T T T T T T T T T T T T T T _ _ G G G G G G G G G _ _ B _ _ _ G G G G G G G G G G G G G G _ _ _ _ T T T T T _ _ G G _ _ _ _ G G _ _ _ _ W W W W W W W W W W M m m M _ _ _ _ _ T T T T T T T T T T
T T T T T T T T T T T T T T T T T T T T _ _ G G G G G G G G G _ _ B _ _ _ G G G G G G G G G G G G G _ _ _ _ _ T T T T T T T T T T T _ _ G _ _ _ _ _ _ _ _ _ _ _ _ _ _ _ M m m M _ _ _ _ _ T T T T T T T T T T
T T T T T T T T T T T T T T T T T T T T _ _ G G G G G G G G _ _ _ B _ _ _ _ G G G G _ _ _ G G G _ _ _ _ _ _ _ T T T T T T T T T T T _ _ _ _ _ _ _ M m m m m m m m m m m m m m M _ _ _ _ _ T T T T T T T T T T
T T T T T T T T T T T T T T T T T T T T _ _ _ G G G G G _ W W W W W W W W W W W W W W W W _ _ _ _ _ _ _ _ _ _ T T T T T T T T T T T _ _ _ _ _ _ _ M m m m m m m m m m m m m m M G G G _ _ T T T T T T T T T T
T T T T T T T T T T T T T T T T T T T T _ _ _ G G G _ _ G W W W W W W W W W W W W W W W W B B B B B B B B B B E E E B B B B B B B B B B _ _ _ _ _ M M M M s s M M M M M s s M M G G G G _ T T T T T T T T T T
T T T T T T T T T T T T T T T T T T T T _ _ _ _ G _ _ G G W W W W W W W W W W W W W W W W _ _ _ _ _ _ _ _ _ _ _ _ _ _ _ _ _ _ _ _ _ _ B _ _ _ _ _ _ _ _ _ _ _ _ B G G G G G G G G G G G _ T T T T T T T T T T
T T T T T T T T T T T T T T T T T T T T _ _ _ _ _ _ _ G G W W W W W W W W W W W W W W W W _ _ _ _ _ _ _ _ _ _ _ _ _ _ _ _ _ _ _ _ _ _ B B B B B B B B B B B B B B G G G G G G G G G G G _ T T T T T T T T T T
T T T T T T T T T T T T T T T T T T T T _ _ _ _ _ _ G G G W W W W W W W W W W W W W W W W _ _ _ _ _ _ _ _ _ _ _ _ _ _ _ _ _ _ _ _ _ _ _ _ _ _ _ _ _ _ _ _ G G G G G G G G G G G G G G _ _ T T T T T T T T T T
T T T T T T T T T T T T T T T T T T T T _ _ _ _ _ _ G G G W W W W W W W W W W W W W W W W G G _ _ _ _ _ _ _ _ E E E _ _ _ _ _ _ _ _ _ _ _ _ _ _ _ _ _ _ _ _ G G G G G G G G G G G _ _ _ _ T T T T T T T T T T
T T T T T T T T T T T T T T T T T T T T _ _ _ _ _ _ _ G G W W W W W W W W W W W W W W W W G G G G _ _ _ _ _ _ T T T _ _ _ _ _ _ _ _ _ _ _ _ _ _ _ _ _ _ _ _ G G G G G G G G G G G _ _ _ _ T T T T T T T T T T
T T T T T T T T T T T T T T T T T T T T _ _ _ _ _ _ _ _ _ _ _ _ _ _ _ _ _ _ _ _ _ B B _ _ _ G G G G G _ _ _ _ T T T T T T T T T T T T T T T T T T T T T T T T T T T T T T T T T T T T T T T T T T T T T T T T
T T T T T T T T T T T T T T T T T T T T _ _ _ _ _ _ _ _ _ B B B B B B B B B B B B B B _ _ _ G G G G G G G _ _ T T T T T T T T T T T T T T T T T T T T T T T T T T T T T T T T T T T T T T T T T T T T T T T T
T T T T T T T T T T T T T T T T T T T T B B B B B B B B B _ _ _ _ _ _ _ _ _ _ _ _ _ _ _ _ _ G G G G G G G _ _ T T T T T T T T T T T T T T T T T T T T T T T T T T T T T T T T T T T T T T T T T T T T T T T T
T T T T T T T T T T T T T T T T T T T T _ _ _ _ _ _ _ _ _ _ _ _ _ _ _ _ _ _ _ _ _ _ _ _ _ _ _ G G G G _ _ _ _ T T T T T T T T T T T T T T T T T T T T T T T T T T T T T T T T T T T T T T T T T T T T T T T T
T T T T T T T T T T T T T T T T T T T T _ _ _ _ _ G G G G G G G G _ _ _ _ _ _ _ _ _ _ _ _ _ G G G G G G G _ _ T T T T T T T T T T T T T T T T T T T T T T T T T T T T T T T T T T T T T T T T T T T T T T T T
T T T T T T T T T T T T T T T T T T T T _ _ _ _ G G G G G G G G G G _ _ _ _ _ _ _ _ _ _ _ _ G G G G G G G _ _ T T T T T T T T T T T T T T T T T T T T T T T T T T T T T T T T T T T T T T T T T T T T T T T T
T T T T T T T T T T T T T T T T T T T T _ _ _ _ G G G G G G G G G G _ _ _ _ _ _ _ _ _ _ _ G G G G G _ _ _ _ _ T T T T T T T T T T T T T T T T T T T T T T T T T T T T T T T T T T T T T T T T T T T T T T T T
T T T T T T T T T T T T T T T T T T T T _ _ _ _ _ G G G G G G G G _ _ _ _ _ _ _ _ _ _ _ _ G G G G _ _ _ _ _ _ T T T T T T T T T T T T T T T T T T T T T T T T T T T T T T T T T T T T T T T T T T T T T T T T
T T T T T T T T T T T T T T T T T T T T _ _ _ _ _ G G G G G G G G G G _ _ _ _ _ _ _ _ _ G G G G _ _ _ _ _ _ _ T T T T T T T T T T T T T T T T T T T T T T T T T T T T T T T T T T T T T T T T T T T T T T T T
T T T T T T T T T T T T T T T T T T T T _ _ _ _ _ _ G G G G G G G G _ _ P _ _ _ _ _ _ G G G G _ _ _ _ _ _ _ _ T T T T T T T T T T T T T T T T T T T T T T T T T T T T T T T T T T T T T T T T T T T T T T T T
T T T T T T T T T T T T T T T T T T T T _ _ _ _ _ _ _ _ _ _ _ _ _ _ _ _ _ _ _ _ _ _ _ _ _ _ _ _ _ _ _ _ _ _ _ T T T T T T T T T T T T T T T T T T T T T T T T T T T T T T T T T T T T T T T T T T T T T T T T
T T T T T T T T T T T T T T T T T T T T T T T T T T T T T T T T T T T T T T T T T T T T T T T T T T T T T T T T T T T T T T T T T T T T T T T T T T T T T T T T T T T T T T T T T T T T T T T T T T T T T T T
T T T T T T T T T T T T T T T T T T T T T T T T T T T T T T T T T T T T T T T T T T T T T T T T T T T T T T T T T T T T T T T T T T T T T T T T T T T T T T T T T T T T T T T T T T T T T T T T T T T T T T T
T T T T T T T T T T T T T T T T T T T T T * * * * * * * * T T T T T T T T T T T T T T T T T T T T T T T T T T T T T T T T T T T T T T T T T T T T T T T T T T T T T T T T T T T T T T T T T T T T T T T T T T
T T T T T T T T T T T T T T T T T T T T T * Z O N E - 1 * T T T T T T T T T T T T T T T T T T T T T T T T T T T T T T T T T T T T T T T T T T T T T T T T T T T T T T T T T T T T T T T T T T T T T T T T T T
T T T T T T T T T T T T T T T T T T T T T * * * * * * * * T T T T T T T T T T T T T T T T T T T T T T T T T T T T T T T T T T T T T T T T T T T T T T T T T T T T T T T T T T T T T T T T T T T T T T T T T T
T T T T T T T T T T T T T T T T T T T T T T T T T T T T T T T T T T T T T T T T T T T T T T T T T T T T T T T T T T T T T T T T T T T T T T T T T T T T T T T T T T T T T T T T T T T T T T T T T T T T T T T
T T T T T T T T T T T T T T T T T T T T T T T T T T T T T T T T T T T T T T T T T T T T T T T T T T T T T T T T T T T T T T T T T T T T T T T T T T T T T T T T T T T T T T T T T T T T T T T T T T T T T T T
T T T T T T T T T T T T T T T T T T T T T T T T T T T T T T T T T T T T T T T T T T T T T T T T T T T T T T T T T T T T T T T T T T T T T T T T T T T T T T T T T T T T T T T T T T T T T T T T T T T T T T T
T T T T T T T T T T T T T T T T T T T T T T T T T T T T T T T T T T T T T T T T T T T T T T T T T T T T T T T T T T T T T T T T T T T T T T T T T T T T T T T T T T T T T T T T T T T T T T T T T T T T T T T
T T T T T T T T T T T T T T T T T T T T T T T T T T T T T T T T T T T T T T T T T T T T T T T T T T T T T T T T T T T T T T T T T T T T T T T T T T T T T T T T T T T T T T T T T T T T T T T T T T T T T T T
T T T T T T T T T T T T T T T T T T T T T T T T T T T T T T T T T T T T T T T T T T T T T T T T T T T T T T T T T T T T T T T T T T T T T T T T T T T T T T T T T T T T T T T T T T T T T T T T T T T T T T T
