T T T T T T T T T T T T T T T T T T T T T T T T T T T T T T T T T T T T T T T T T T T T T T T T T T T T T T T T T T T T
T T T T T T T T T T T T T T T T T T T T T T T T T T T T T T T T T T T T T T T T T T T T T T T T T T T T T T T T T T T T
T T T T T T T T T T T T T T T T T T T T T T T T T T T T T T T T T T T T T T T T T T T T T T T T T T T T T T T T T T T T
T T T T T T T T T T T T T T T T T T T T T T T T T T T T T T T T T T T T T T T T T T T T T T T T T T T T T T T T T T T T
T T T T T T T T T T T T T T T T T T T T T T T T T T T T T T T T T T T T T T T T T T T T T T T T T T T T T T T T T T T T
T T T T T T T T T T T T T T T T T T T T T T T T T T T T T T T T T T T T T T T T T T T T T T T T T T T T T T T T T T T T
T T T T T T T T T T T T T T T T T T T T T T T T T T T T T T T T T T T T T T T T T T T T T T T T T T T T T T T T T T T T
T T T T T T T T T T T T T T T T T T T T T T T T T E _ _ E T T T T T T T T T T T T T T T T T T T T T T T T T T T T T T T
T T T T T T T T T T T T T T T T T T T T T T T T T E _ _ E T T T T T T T T T T T T T T T T T T T T T T T T T T T T T T T
T T T T T T T T T T T T T T T T T T T T T T T T T E _ _ E T T T T T T T T T T T T T T T T T T T T T T T T T T T T T T T
T T T T T T T T T T _ _ _ _ _ _ _ _ _ _ _ _ _ B _ _ _ _ _ _ _ _ _ _ _ _ _ _ _ _ _ _ _ _ _ T T T T T T T T T T T T T T T
T T T T T T T T T T _ _ _ _ _ _ _ _ _ _ _ _ _ B _ _ _ _ _ _ _ _ _ G G G G G _ _ _ _ _ _ _ T T T T T T T T T T T T T T T
T T T T T T T T T T _ _ _ _ _ G G G G _ _ _ _ B _ _ _ _ _ G G G G G G G G G G G _ _ _ _ _ T T T T T T T T T T T T T T T
T T T T T T T T T T _ _ _ G G G G G G G G _ _ B _ _ _ _ G G G G G G G G G G G G G _ _ _ _ T T T T T T T T T T T T T T T
T T T T T T T T T T _ _ G G G G G G G G G _ _ B _ _ _ G G G G G G G G G G G G G G _ _ _ _ T T T T T T T T T T T T T T T
T T T T T T T T T T _ _ G G G G G G G G G _ _ B _ _ _ G G G G G G G G G G G G G _ _ _ _ _ T T T T T T T T T T T T T T T
T T T T T T T T T T _ _ G G G G G G G G _ _ _ B _ _ _ _ G G G G _ _ _ G G G _ _ _ _ _ _ _ T T T T T T T T T T T T T T T
T T T T T T T T T T _ _ _ G G G G G _ W W W W W W W W W W W W W W W W _ _ _ _ _ _ _ _ _ _ T T T T T T T T T T T T T T T
T T T T T T T T T T _ _ _ G G G _ _ G W W W W W W W W W W W W W W W W B B B B B B B B B B E E E T T T T T T T T T T T T
T T T T T T T T T T _ _ _ _ G _ _ G G W W W W W W W W W W W W W W W W _ _ _ _ _ _ _ _ _ _ _ _ _ T T T T T T T T T T T T
T T T T T T T T T T _ _ _ _ _ _ _ G G W W W W W W W W W W W W W W W W _ _ _ _ _ _ _ _ _ _ _ _ _ T T T T T T T T T T T T
T T T T T T T T T T _ _ _ _ _ _ G G G W W W W W W W W W W W W W W W W _ _ _ _ _ _ _ _ _ _ E E E T T T T T T T T T T T T
T T T T T T T T T T _ _ _ _ _ _ G G G W W W W W W W W W W W W W W W W G G _ _ _ _ _ _ _ _ T T T T T T T T T T T T T T T
T T T T T T T T T T _ _ _ _ _ _ _ G G W W W W W W W W W W W W W W W W G G G G _ _ _ _ _ _ T T T T T T T T T T T T T T T
T T T T T T T T T T _ _ _ _ _ _ _ _ _ _ _ _ _ _ _ _ _ _ _ _ _ B B _ _ _ G G G G G _ _ _ _ T T T T T T T T T T T T T T T
T T T T T T T T T T _ _ _ _ _ _ _ _ _ B B B B B B B B B B B B B B _ _ _ G G G G G G G _ _ T T T T T T T T T T T T T T T
T T T T T T T T T T B B B B B B B B B _ _ _ _ _ _ _ _ _ _ _ _ _ _ _ _ _ G G G G G G G _ _ T T T T T T T T T T T T T T T
T T T T T T T T T T _ _ _ _ _ _ _ _ _ _ _ _ _ _ _ _ _ _ _ _ _ _ _ _ _ _ _ G G G G _ _ _ _ T T T T T T T T T T T T T T T
T T T T T T T T T T _ _ _ _ _ G G G G G G G G _ _ _ _ _ _ _ _ _ _ _ _ _ G G G G G G G _ _ T T T T T T T T T T T T T T T
T T T T T T T T T T _ _ _ _ G G G G G G G G G G _ _ _ _ _ _ _ _ _ _ _ _ G G G G G G G _ _ T T T T T T T T T T T T T T T
T T T T T T T T T T _ _ _ _ G G G G G G G G G G _ _ _ _ _ _ _ _ _ _ _ G G G G G _ _ _ _ _ T T T T T T T T T T T T T T T
T T T T T T T T T T _ _ _ _ _ G G G G G G G G _ _ _ _ _ _ _ _ _ _ _ _ G G G G _ _ _ _ _ _ T T T T T T T T T T T T T T T
T T T T T T T T T T _ _ _ _ _ G G G G G G G G G G _ _ _ _ _ _ _ _ _ G G G G _ _ _ _ _ _ _ T T T T T T T T T T T T T T T
T T T T T T T T T T _ _ _ _ _ _ G G G G G G G G _ _ P _ _ _ _ _ _ G G G G _ _ _ _ _ _ _ _ T T T T T T T T T T T T T T T
T T T T T T T T T T _ _ _ _ _ _ _ _ _ _ _ _ _ _ _ _ _ _ _ _ _ _ _ _ _ _ _ _ _ _ _ _ _ _ _ T T T T T T T T T T T T T T T
T T T T T T T T T T T T T T T T T T T T T T T T T T T T T T T T T T T T T T T T T T T T T T T T T T T T T T T T T T T T
T T T T T T T T T T T T T T T T T T T T T T T T T T T T T T T T T T T T T T T T T T T T T T T T T T T T T T T T T T T T
T T T T T T T T T T T T T T T T T T T T T T T T T T T T T T T T T T T T T T T T T T T T T T T T T T T T T T T T T T T T
T T T T T T T T T T T T T T T T T T T T T T T T T T T T T T T T T T T T T T T T T T T T T T T T T T T T T T T T T T T T
T T T T T T T T T T T T T T T T T T T T T T T T T T T T T T T T T T T T T T T T T T T T T T T T T T T T T T T T T T T T
T T T T T T T T T T T T T T T T T T T T T T T T T T T T T T T T T T T T T T T T T T T T T T T T T T T T T T T T T T T T
T T T T T T T T T T T T T T T T T T T T T T T T T T T T T T T T T T T T T T T T T T T T T T T T T T T T T T T T T T T T
T T T T T T T T T T T T T T T T T T T T T T T T T T T T T T T T T T T T T T T T T T T T T T T T T T T T T T T T T T T T
T T T T T T T T T T T T T T T T T T T T T T T T T T T T T T T T T T T T T T T T T T T T T T T T T T T T T T T T T T T T
T T T T T T T T T T T T T T T T T T T T T T T T T T T T T T T T T T T T T T T T T T T T T T T T T T T T T T T T T T T T
T T T T T T T T T T T T T T T T T T T T T T T T T T T T T T T T T T T T T T T T T T T T T T T T T T T T T T T T T T T T
