T T T T T T T T T T T T T T T T T T T T T T T T T T T T T T T T T T T T T T T T T T T T T T T T T T T T T T T T T T T T T T T T T T T T T T T T T T T T T T T T T T T T T T T T T T T T T T T T T T T T T T T T T T T T T T T T T T T T T T T T T T T T T T T T T T T T T
T T T T T T T T T T T T T T T T T T T T T T T T T T T T T T T T T T T T T T T T T T T T T T T T T T T T T T T T T T T T T T T T T T T T T T T T T T T T T T T T T T T T T T T T T T T T T T T T T T T T T T T T T T T T T T T T T T T T T T T T T T T T T T T T T T T T T
T T T T T T T T T T T T T T T T T T T T T T T T T T T T T T T T T T T T T T T T T T T T T T T T T T T T T T T T T T T T T T T T T T T T T T T T T T T T T T T T T T T T T T T T T T T T T T T T T T T T T T T T T T T T T T T T T T T T T T T T T T T T T T T T T T T T T
T T T T T T T T T T T T T T T T T T T T T T T T T T T T T T T T T T T T T T T T T T T T T T T T T T T T T T T T T T T T T T T T T T T T T T T T T T T T T T T T T T T T T T T T T T T T T T T T T T T T T T T T T T T T T T T T T T T T T T T T T T T T T T T T T T T T T
T T T T T T T T T T T T T T T T T T T T T T T T T T T T T T T T T T T T T T T T T T T T T T T T T T T T T T T T T T T T T T T T T T T T T T T T T T T T T T T T T T T T T T T T T T T T T T T T T T T T T T T T T T T T T T T T T T T T T T T T T T T T T T T T T T T T T
T T T T T T T T T T T T T T T T T T T T T T T T T T T T T T T T T T T T T T T T T T T T T T T T T T T T T T T T T T T T T T T T T T T T T T T T T T T T T T T T T T T T T T T T T T T T T T T T T T T T T T T T T T T T T T T T T T T T T T T T T T T T T T T T T T T T T
T T T T T T T T T T T T T T T T T T T T T T T T T T T T T T T T T T T T T T T T T T T T T T T T T T T T T T T T T T T T T T T T T T T T T T T T T T T T T T T T T T T T T T T T T T T T T T T T T T T T T T T T T T T T T T T T T T T T T T T T T T T T T T T T T T T T T
T T T T T T T T T T T T T T T T T T T T T T T T T T T T T T T T T T T T T T T T T T T T T T T T T T T T T T T T T T T T T T T T T T T T T T T T T T T T T T T T T T T T T T T T T T T T T T T T T T T T T T T T T T T T T T T T T T T T T T T T T T T T T T T T T T T T T
T T T T T T T T T T T T T T T T T T T T T T T T T T T T T T T T T T T T T T T T T T T T T T T T T T T T T T T T T T T T T T T T T T T T T T T T T T T T T T T T T T T T T T T T T T T T T T T T T T T T T T T T T T T T T T T T T T T T T T T T T T T T T T T T T T T T T
T T T T T T T T T T T T T T T T T T T T T T T T T T T T T T T T T T T T T T T T T T T T T T T T T T T T T T T T T T T T T T T T T T T T T T T T T T T T T T T T T T T T T T T T T T T T T T T T T T T T T T T T T T T T T T T T T T T T T T T T T T T T T T T T T T T T T
T T T T T T T T T T T T T T T T T T T T T T T T T T T T T T T T T T T T T T T T T T T T T T T T T T T T T T T T T T T T T T T T T T T T T T T T T T T T T T T T T T T T T T T T T T T T T T T T T T T T T T T T T T T T T T T T T T T T T T T T T T T T T T T T T T T T T
T T T T T T T T T T T T T T T T T T T T T T T T T T T T T T T T T T T T T T T T T T T T T T T T T T T T T T T T T T T T T T T T T T T T T T T T T T T T T T T T T T T T T T T T T T T T T T T T T T T T T T T T T T T T T T T T T T T T T T T T T T T T T T T T T T T T T
T T T T T T T T T T T T T T T T T T T T T T T T T T T T T T T T T T T T T T T T T T T T T T T T T T T T T T T T T T T T T T T T T T T T T T T T T T T T T T T T T T T T T T T T T T T T T T T T T T T T T T T T T T T T T T T T T T T T T T T T T T T T T T T T T T T T T
T T T T T T T T T T T T T T T T T T T T T T T T T T T T T T T T T T T T T T T T T T T T T T T T T T T T T T T T T T T T T T T T T T T T T T T T T T T T T T T T T T T T T T T T T T T T T T T T T T T T T T T T T T T T T T T T T T T T T T T T T T T T T T T T T T T T T
T T T T T T T T T T T T T T T T T T T T T T T T T T T T T T T T T T T T T T T T T T T T T T T T T T T T T T T T T T T T T T T T T T T T T T T T T T T T T T T T T T T T T T T T T T T T T T T T T T T T T T T T T T T T T T T T T T T T T T T T T T T T T T T T T T T T T
T T T T T T T T T T T T T T T T T T T T T T T T T T T T T T T T T T T T T T T T T T T T T T T T T T T T T T T T T T T T T T T T T T T T T T T T T T T T T T T T T T T T T T T T T T T T T T T T T T T T T T T T T T T T T T T T T T T T T T T T T T T T T T T T T T T T T
T T T T T T T T T T T T T T T T T T T T T T T T T T T T T T T T T T T T T T T T T T T T T T T T T T T T T T T T T T T T T T T T T T T T T T T T T T T T T T T T T T T T T T T T T T T T T T T T T T T T T T T T T T T T T T T T T T T T T T T T T T T T T T T T T T T T T
T T T T T T T T T T T T T T T T T T T T T T T T T T T T T T T T T T T T T T T T T T T T T T T T T T T T T T T T T T T T T T T T T T T T T T T T T T T T T T T T T T T T T T T T T T T T T T T T T T T T T T T T T T T T T T T T T T T T T T T T T T T T T T T T T T T T T
T T T T T T T T T T T T T T T T T T T T T T T T T T T T T T T T T T T T T T T T T T T T T T T T T T T T T T T T T T T T T T T T T T T T T T T T T T T T T T T T T T T T T T T T T T T T T T T T T T T T T T T T T T T T T T T T T T T T T T T T T T T T T T T T T T T T T
T T T T T T T T T T T T T T T T T T T T T T T T T T T T T T T T T T T T T T T T T T T T T T T T T T T T T T T T T T T T T T T T T T T T T T T T T T T T T T T T T T T T T T T T T T T T T T T T T T T T T T T T T T T T T T T T T T T T T T T T T T T T T T T T T T T T T
T T T T T T T T T T T T T T T T T T T T T T T T T T T T T T T T T T T T T T T T T T T T T T T T T T T T T T T T T T T T T T T T T T T T T T T T T T T T T T T T T T T T T T T T T T T T T T T T T T T T T T T T T T T T T T T T T T T T T T T T T T T T T T T T T T T T T
T T T T T T T T T T T T T T T T T T T T T T T T T T T T T T _ _ G _ _ _ _ _ _ _ _ _ _ _ _ _ _ _ _ _ _ _ _ G G G G G G G G G G _ _ _ _ _ _ _ _ G G _ _ T T T T T T T T T T T T T T T T T T T T T T T T T T T T T T T T T T T T T T T T T T T T T T T T T T T T T T T T T T
T T T T T T T T T T T T T T T T T T T T T T T T T T T T T T _ G G G _ _ _ _ _ _ _ _ _ _ _ _ _ _ _ _ _ _ _ G G G G G G G G G G G G G _ _ G G G G G G _ T T T T T T T T T T T T T T T T T T T T T T T T T T T T T T T T T T T T T T T T T T T T T T T T T T T T T T T T T T
T T T T T T T T T T T T T T T T T T T T T T T T T T T T T T G G B G G _ _ _ _ _ _ _ _ T T T B B B B B B B B B B B B G G G G G G G G G G G G G G G G _ T T T T T T T T T T T T T T T T T T T T T T T T T T T T T T T T T T T T T T T T T T T T T T T T T T T T T T T T T T
T T T T T T T T T T T T T T T T T T T T T T T T T T T T T T _ G G G _ W W W W W W W W T T T _ _ _ _ _ _ _ _ _ _ _ _ _ G G G G G G G G G G G G G G _ _ T T T T T T T T T T T T T T T T T T T T T T T T T T T T T T T T T T T T T T T T T T T T T T T T T T T T T T T T T T
T T T T T T T T T T T T T T T T T T T T T T T T T T T T T T _ _ G _ _ W W W W W W W W T T T _ _ _ _ _ _ _ _ _ _ _ _ _ _ _ _ G G G G G _ _ _ _ _ _ _ _ T T T T T T T T T T T T T T T T T T T T T T T T T T T T T T T T T T T T T T T T T T T T T T T T T T T T T T T T T T
T T T T T T T T T T T T T T T T T T T T T T T T T T T T T T T _ _ _ _ W W W W W W W W W W W _ _ _ _ _ _ T T T B B B B B B B B B B B B _ _ _ _ _ _ _ _ T T T T T T T T T T T T T T T T T T T T T T T T T T T T T T T T T T T T T T T T T T T T T T T T T T T T T T T T T T
T T T T T T T T T T T T T T T T T T T T T T T T T T T T T T T _ _ _ _ W W W W W W W W W W W _ _ G G G G T T T _ _ _ _ _ _ _ _ _ _ _ q t t t t t t t o T T T T T T T T T T T T T T T T T T T T T T T T T T T T T T T T T T T T T T T T T T T T T T T T T T T T T T T T T T
T T T T T T T T T T T T T T T T T T T T T T T T T T T T T T T _ _ _ W W W W W W G G G G G G G G G G G _ T T T _ _ _ _ _ _ _ _ _ _ _ l m m m m m m m r T T T T T T T T T T T T T T T T T T T T T T T T T T T T T T T T T T T T T T T T T T T T T T T T T T T T T T T T T T
T T T T T T T T T T T T T T T T T T T T T T T T T T T T T T T _ _ _ W W W W W W G G G G G G G G G G _ _ B _ _ _ _ _ _ _ _ _ _ _ _ _ l m m m m m m m r T T T T T T T T T T T T T T T T T T T T T T T T T T T T T T T T T T T T T T T T T T T T T T T T T T T T T T T T T T
T T T T T T T T T T T T T T T T T T T T T T T T T T T T T T T W W W _ _ _ _ _ _ _ _ _ _ G G G G G _ _ _ B _ _ _ _ _ _ _ _ _ _ _ _ _ z b s s b m m m r T T T T T T T T T T T T * * * * * * * * T T T T T T T T T T T T T T T T T T T T T T T T T T T T T T T T T T T T T T
T T T T T T T T T T T T T T T T T T T T T T T T T T T T T T T W W W _ _ _ _ _ _ _ _ _ _ _ _ G G _ _ _ _ B _ _ _ _ _ _ _ _ _ _ _ _ _ _ _ _ _ _ l m m r T T T T T T T T T T T T * Z O N E - 2 * T T T T T T T T T T T T T T T T T T T T T T T T T T T T T T T T T T T T T T
T T T T T T T T T T T T T T T T T T T T T T T T T T T T T T T W W W _ _ _ _ _ _ _ _ _ _ _ _ _ _ _ _ q t t t t t t t t t o _ _ _ _ _ _ _ _ _ _ l m m r T T T T T T T T T T T T * * * * * * * * T T T T T T T T T T T T T T T T T T T T T T T T T T T T T T T T T T T T T T
T T T T T T T T T T T T T T T T T T T T T T T T T T T T T T T W W W _ _ _ _ G G G G G G _ _ _ _ _ _ l m m m m m m m m m r _ _ _ _ _ _ _ _ _ _ l m m r T T T T T T T T T T T T T T T T T T T T T T T T T T T T T T T T T T T T T T T T T T T T T T T T T T T T T T T T T T
T T T T T T T T T T T T T T T T T T T T T T T T T T T T T T T W W W _ G G G G G G G G G G G _ _ _ _ l m m m m m b s s b n q t t t t t t t t t m m m r T T T T T T T T T T T T T T T T T T T T T T T T T T T T T T T T T T T T T T T T T T T T T T T T T T T T T T T T T T
T T T T T T T T T T T T T T T T T T T T T T T T T T T T T T T T B _ G G G G G G G G G G G G G G G _ l m m m m r G G G G G l m m m m m m m m m m m m r T T T T T T T T T T T T T T T T T T T T T T T T T T T T T T T T T T T T T T T T T T T T T T T T T T T T T T T T T T
T T T T T T T T T T T T T T T T T T T T T T T T T T T T T T T T B G G G G G G G G G G G G G G G G _ l m m m m r G G G G G l m m m m m m m m m m m m r T T T T T T T T T T T T T T T T T T T T T T T T T T T T T T T T T T T T T T T T T T T T T T T T T T T T T T T T T T
T T T T T T T T T T T T T T T T T T T T T T T T T T T T T T T T B G G W W W W W W W W W W W W W G G z s s b b n G G G G G z b b s s b b b b b b b b n T T T T T T T T T T T T T T T T T T T T T T T T T T T T T T T T T T T T T T T T T T T T T T T T T T T T T T T T T T
T T T T T T T T T T T T T T T T T T T T T T T T T T T T T T T T B G G W W W W W W W W W W W W W G G _ _ _ B G G G G G G G B _ _ _ _ _ _ _ _ _ _ _ _ _ T T T _ _ _ _ _ _ _ _ _ _ G G G G G G G G G G G G G G G G _ _ _ G G G G G _ T T T T T T T T T T T T T T T T T T T T
T T T T T T T T T T T T T T T T T T T T T T T T T T T T T T T R R G G W W W W W W W W W W W W W G _ _ _ _ B G G G G G G G _ _ _ _ _ _ _ _ _ _ _ _ _ _ T T T _ _ _ _ _ _ _ _ _ _ G G G G G G G G G G G G G G _ _ _ _ G G G G G G G T T T T T T T T T T T T T T T T T T T T
T T T T T T T T T T T T T T T T T T T T T T T T T T T T T T T R R G G W W W W W W W W _ _ _ _ _ _ _ _ _ _ B G G G G G G G G G _ _ _ _ _ _ _ _ _ _ _ _ E E E B B B B B B B B _ _ _ _ G G G G G G G G G G _ _ _ _ _ G G G G G G G G T T T T T T T T T T T T T T T T T T T T
T T T T T T T T T T T T T T T T T T T T T T T T T T T T T T T E G G G W W W W W W W W _ _ _ _ _ _ _ _ _ _ B _ _ G G G G G G G G _ _ _ _ _ _ _ _ _ _ _ _ _ _ _ _ _ _ _ _ _ _ _ _ _ _ q t t t t t t t t t t t o G G G G G G G G G G T T T T T T T T T T T T T T T T T T T T
T T T T T T T T T T T T T T T T T T T T T T T T T T T T T T T E G G G G G G _ _ _ _ _ _ _ _ _ _ _ _ _ _ _ B _ _ G G G G G G G G _ _ _ _ _ _ _ _ _ _ _ _ _ _ _ _ _ _ _ _ _ _ _ _ _ _ l m m m m m m m m m m m r G G G G G G G G G G T T T T T T T T T T T T T T T T T T T T
T T T T T T T T T T T T T T T T T T T T T T T T T T T T T T T E _ G G G G _ _ _ _ _ _ _ _ _ _ _ _ _ _ _ _ E _ _ _ _ _ G G G _ _ _ _ _ _ _ _ _ _ _ _ _ E E E E E B B B B B B B B B B l m m m m m m m m m m m r _ G G G G G G G G G T T T T T T T T T T T T T T T T T T T T
T T T T T T T T T T T T T T T T T T T T T T T T T T T T T T T E _ _ _ _ _ _ _ _ _ _ _ _ _ _ _ _ _ _ _ _ _ E _ _ _ _ _ G G G _ _ _ _ _ _ _ _ _ _ _ _ _ T T T T T _ _ _ _ _ _ _ _ _ _ z b s s b b b b b s s b n G G G G G G G G G G T T T T T T T T T T T T T T T T T T T T
T T T T T T T T T T T T T T T T T T T T T T T T T T T T T T E _ E E _ _ E T T T T T T T T T T T T T T T T E E E _ _ _ E _ _ _ _ _ _ _ _ _ _ _ _ _ _ _ T T T T T _ _ _ G _ _ _ _ G _ _ _ _ _ _ E E _ _ _ _ _ _ _ G G _ G G G G G _ T T T T T T T T T T T T T T T T T T T T
T T T T T T T T T T T T T T T T T T T T T T T T T T T T T T T T T E _ _ E T T T T T T T T T T T T T T T T T T E _ _ _ E T T T T T T T T T T T T T T T T T T T T _ _ G G _ _ _ _ G G _ _ _ _ _ E E _ _ _ _ _ _ _ _ _ _ _ G G G _ _ T T T T T T T T T T T T T T T T T T T T
T T T T T T T T T T T T T T T T T T T T T T T T T T T T T T T T T E _ _ E T T T T T T T T T T T T T T T T T T E _ _ _ E T T T T T T T T T T T T T T T T T T T T _ G G G _ G G _ G G G _ _ _ W W W W W W W W W W _ _ _ _ _ _ _ _ _ T T T T T T T T T T T T T T T T T T T T
T T T T T T T T T T T T T T T T T T T T T T T T T T T T T T T T T E _ _ E T T T T T T T T T T T T T T T T T T E _ _ _ E T T T T T T T T T T T T T T T T T T T T G _ _ _ G G G G _ _ _ _ _ _ W W W W W W W W W W _ _ _ _ _ _ _ _ _ T T T T T T T T T T T T T T T T T T T T
T T T T T T T T T T T T T T T T T T T T T T T T T T T T T T T T T T T T T T T T _ _ _ _ _ _ _ _ _ _ _ _ _ B _ _ _ _ _ _ _ _ _ _ _ _ _ _ _ _ _ _ _ _ _ T T T T T G _ _ G G G G G G _ _ _ _ _ W W W W W W W W W q t t t t t t t t o T T T T T T T T T T T T T T T T T T T T
T T T T T T T T T T T T T T T T T T T T T T T T T T T T T T T T T T T T T T T T _ _ _ _ _ _ _ _ _ _ _ _ _ B _ _ _ _ _ _ _ _ _ G G G G G _ _ _ _ _ _ _ T T T T T G _ _ G G G G G G _ _ _ _ G G G G G G G G G W l m m m m m m m m r T T T T T T T T T T T T T T T T T T T T
T T T T T T T T T T T T T T T T T T T T T T T T T T T T T T T T T T T T T T T T _ _ _ _ _ G G G G _ _ _ _ B _ _ _ _ _ G G G G G G G G G G G _ _ _ _ _ T T T T T G _ _ _ G G G G _ _ _ _ _ G G G G G G G G G W z m m m r s s b b n T T T T T T T T T T T T T T T T T T T T
T T T T T T T T T T T T T T T T T T T T T T T T T T T T T T T T T T T T T T T T _ _ _ G G G G G G G G _ _ B _ _ _ _ G G G G G G G G G G G G G _ _ _ _ T T T T T _ G G G _ G G _ G G G _ _ _ W W W W W W W W W W l m m r _ _ _ _ _ T T T T T T T T T T T T T T T T T T T T
T T T T T T T T T T T T T T T T T T T T T T T T T T T T T T T T T T T T T T T T _ _ G G G G G G G G G _ _ B _ _ _ G G G G G G G G G G G G G G _ _ _ _ T T T T T _ _ G G _ _ _ _ G G _ _ _ _ W W W W W W W W W W l m m r _ _ _ _ _ T T T T T T T T T T T T T T T T T T T T
T T T T T T T T T T T T T T T T T T T T T T T T T T T T T T T T T T T T T T T T _ _ G G G G G G G G G _ _ B _ _ _ G G G G G G G G G G G G G _ _ _ _ _ T T T T T T T T T T T _ _ G _ _ _ _ _ _ _ _ _ _ _ _ _ _ _ l m m r _ _ _ _ _ T T T T T T T T T T T T T T T T T T T T
T T T T T T T T T T T T T T T T T T T T T T T T T T T T T T T T T T T T T T T T _ _ G G G G G G G G _ _ _ B _ _ _ _ G G G G _ _ _ G G G _ _ _ _ _ _ _ T T T T T T T T T T T _ _ _ _ _ _ _ q t t t t t t t t t t m m m r _ _ _ _ _ T T T T T T T T T T T T T T T T T T T T
T T T T T T T T T T T T T T T T T T T T T T T T T T T T T T T T T T T T T T T T _ _ _ G G G G G _ W W W W W W W W W W W W W W W W _ _ _ _ _ _ _ _ _ _ T T T T T T T T T T T _ _ _ _ _ _ _ l m m m m m m m m m m m m m r G G G _ _ T T T T T T T T T T T T T T T T T T T T
T T T T T T T T T T T T T T T T T T T T T T T T T T T T T T T T T T T T T T T T _ _ _ G G G _ _ G W W W W W W W W W W W W W W W W B B B B B B B B B B E E E B B B B B B B B B B _ _ _ _ _ z b b b s s b b b b b s s b n G G G G _ T T T T T T T T T T T T T T T T T T T T
T T T T T T T T T T T T T T T T T T T T T T T T T T T T T T T T T T T T T T T T _ _ _ _ G _ _ G G W W W W W W W W W W W W W W W W _ _ _ _ _ _ _ _ _ _ _ _ _ _ _ _ _ _ _ _ _ _ B _ _ _ _ _ _ _ _ _ _ _ _ B G G G G G G G G G G G _ T T T T T T T T T T T T T T T T T T T T
T T T T T T T T T T T T T T T T T T T T T T T T T T T T T T T T T T T T T T T T _ _ _ _ _ _ _ G G W W W W W W W W W W W W W W W W _ _ _ _ _ _ _ _ _ _ _ _ _ _ _ _ _ _ _ _ _ _ B B B B B B B B B B B B B B G G G G G G G G G G G _ T T T T T T T T T T T T T T T T T T T T
T T T T T T T T T T T T T T T T T T T T T T T T T T T T T T T T T T T T T T T T _ _ _ _ _ _ G G G W W W W W W W W W W W W W W W W _ _ _ _ _ _ _ _ _ _ _ _ _ _ _ _ _ _ _ _ _ _ _ _ _ _ _ _ _ _ _ _ G G G G G G G G G G G G G G _ _ T T T T T T T T T T T T T T T T T T T T
T T T T T T T T T T T T T T T T T T T T T T T T T T T T T T T T T T T T T T T T _ _ _ _ _ _ G G G W W W W W W W W W W W W W W W W G G _ _ _ _ _ _ _ _ E E E _ _ _ _ _ _ _ _ _ _ _ _ _ _ _ _ _ _ _ _ G G G G G G G G G G G _ _ _ _ T T T T T T T T T T T T T T T T T T T T
T T T T T T T T T T T T T T T T T T T T T T T T T T T T T T T T T T T T T T T T _ _ _ _ _ _ _ G G W W W W W W W W W W W W W W W W G G G G _ _ _ _ _ _ T T T _ _ _ _ _ _ _ _ _ _ _ _ _ _ _ _ _ _ _ _ G G G G G G G G G G G _ _ _ _ T T T T T T T T T T T T T T T T T T T T
T T T T T T T T T T T T T T T T T T T T T T T T T T T T T T T T T T T T T T T T _ _ _ _ _ _ _ _ _ _ _ _ _ _ _ _ _ _ _ _ _ B B _ _ _ G G G G G _ _ _ _ T T T T T T T T T T T T T T T T T T T T T T T T T T T T T T T T T T T T T T T T T T T T T T T T T T T T T T T T T T
T T T T T T T T T T T T T T T T T T T T T T T T T T T T T T T T T T T T T T T T _ _ _ _ _ _ _ _ _ B B B B B B B B B B B B B B _ _ _ G G G G G G G _ _ T T T T T T T T T T T T T T T T T T T T T T T T T T T T T T T T T T T T T T T T T T T T T T T T T T T T T T T T T T
T T T T T T T T T T T T T T T T T T T T T T T T T T T T T T T T T T T T T T T T B B B B B B B B B _ _ _ _ _ _ _ _ _ _ _ _ _ _ _ _ _ G G G G G G G _ _ T T T T T T T T T T T T T T T T T T T T T T T T T T T T T T T T T T T T T T T T T T T T T T T T T T T T T T T T T T
T T T T T T T T T T T T T T T T T T T T T T T T T T T T T T T T T T T T T T T T _ _ _ _ _ _ _ _ _ _ _ _ _ _ _ _ _ _ _ _ _ _ _ _ _ _ _ G G G G _ _ _ _ T T T T T T T T T T T T T T T T T T T T T T T T T T T T T T T T T T T T T T T T T T T T T T T T T T T T T T T T T T
T T T T T T T T T T T T T T T T T T T T T T T T T T T T T T T T T T T T T T T T _ _ _ _ _ G G G G G G G G _ _ _ _ _ _ _ _ _ _ _ _ _ G G G G G G G _ _ T T T T T T T T T T T T T T T T T T T T T T T T T T T T T T T T T T T T T T T T T T T T T T T T T T T T T T T T T T
T T T T T T T T T T T T T T T T T T T T T T T T T T T T T T T T T T T T T T T T _ _ _ _ G G G G G G G G G G _ _ _ _ _ _ _ _ _ _ _ _ G G G G G G G _ _ T T T T T T T T T T T T T T T T T T T T T T T T T T T T T T T T T T T T T T T T T T T T T T T T T T T T T T T T T T
T T T T T T T T T T T T T T T T T T T T T T T T T T T T T T T T T T T T T T T T _ _ _ _ G G G G G G G G G G _ _ _ _ _ _ _ _ _ _ _ G G G G G _ _ _ _ _ T T T T T T T T T T T T T T T T T T T T T T T T T T T T T T T T T T T T T T T T T T T T T T T T T T T T T T T T T T
T T T T T T T T T T T T T T T T T T T T T T T T T T T T T T T T T T T T T T T T _ _ _ _ _ G G G G G G G G _ _ _ _ _ _ _ _ _ _ _ _ G G G G _ _ _ _ _ _ T T T T T T T T T T T T T T T T T T T T T T T T T T T T T T T T T T T T T T T T T T T T T T T T T T T T T T T T T T
T T T T T T T T T T T T T T T T T T T T T T T T T T T T T T T T T T T T T T T T _ _ _ _ _ G G G G G G G G G G _ _ _ _ _ _ _ _ _ G G G G _ _ _ _ _ _ _ T T T T T T T T T T T T T T T T T T T T T T T T T T T T T T T T T T T T T T T T T T T T T T T T T T T T T T T T T T
T T T T T T T T T T T T T T T T T T T T T T T T T T T T T T T T T T T T T T T T _ _ _ _ _ _ G G G G G G G G _ _ P _ _ _ _ _ _ G G G G _ _ _ _ _ _ _ _ T T T T T T T T T T T T T T T T T T T T T T T T T T T T T T T T T T T T T T T T T T T T T T T T T T T T T T T T T T
T T T T T T T T T T T T T T T T T T T T T T T T T T T T T T T T T T T T T T T T _ _ _ _ _ _ _ _ _ _ _ _ _ _ _ _ _ _ _ _ _ _ _ _ _ _ _ _ _ _ _ _ _ _ _ T T T T T T T T T T T T T T T T T T T T T T T T T T T T T T T T T T T T T T T T T T T T T T T T T T T T T T T T T T
T T T T T T T T T T T T T T T T T T T T T T T T T T T T T T T T T T T T T T T T T T T T T T T T T T T T T T T T T T T T T T T T T T T T T T T T T T T T T T T T T T T T T T T T T T T T T T T T T T T T T T T T T T T T T T T T T T T T T T T T T T T T T T T T T T T T T
T T T T T T T T T T T T T T T T T T T T T T T T T T T T T T T T T T T T T T T T T T T T T T T T T T T T T T T T T T T T T T T T T T T T T T T T T T T T T T T T T T T T T T T T T T T T T T T T T T T T T T T T T T T T T T T T T T T T T T T T T T T T T T T T T T T T T
T T T T T T T T T T T T T T T T T T T T T T T T T T T T T T T T T T T T T T T T T * * * * * * * * T T T T T T T T T T T T T T T T T T T T T T T T T T T T T T T T T T T T T T T T T T T T T T T T T T T T T T T T T T T T T T T T T T T T T T T T T T T T T T T T T T T T
T T T T T T T T T T T T T T T T T T T T T T T T T T T T T T T T T T T T T T T T T * Z O N E - 1 * T T T T T T T T T T T T T T T T T T T T T T T T T T T T T T T T T T T T T T T T T T T T T T T T T T T T T T T T T T T T T T T T T T T T T T T T T T T T T T T T T T T T
T T T T T T T T T T T T T T T T T T T T T T T T T T T T T T T T T T T T T T T T T * * * * * * * * T T T T T T T T T T T T T T T T T T T T T T T T T T T T T T T T T T T T T T T T T T T T T T T T T T T T T T T T T T T T T T T T T T T T T T T T T T T T T T T T T T T T
T T T T T T T T T T T T T T T T T T T T T T T T T T T T T T T T T T T T T T T T T T T T T T T T T T T T T T T T T T T T T T T T T T T T T T T T T T T T T T T T T T T T T T T T T T T T T T T T T T T T T T T T T T T T T T T T T T T T T T T T T T T T T T T T T T T T T
T T T T T T T T T T T T T T T T T T T T T T T T T T T T T T T T T T T T T T T T T T T T T T T T T T T T T T T T T T T T T T T T T T T T T T T T T T T T T T T T T T T T T T T T T T T T T T T T T T T T T T T T T T T T T T T T T T T T T T T T T T T T T T T T T T T T T
T T T T T T T T T T T T T T T T T T T T T T T T T T T T T T T T T T T T T T T T T T T T T T T T T T T T T T T T T T T T T T T T T T T T T T T T T T T T T T T T T T T T T T T T T T T T T T T T T T T T T T T T T T T T T T T T T T T T T T T T T T T T T T T T T T T T T
T T T T T T T T T T T T T T T T T T T T T T T T T T T T T T T T T T T T T T T T T T T T T T T T T T T T T T T T T T T T T T T T T T T T T T T T T T T T T T T T T T T T T T T T T T T T T T T T T T T T T T T T T T T T T T T T T T T T T T T T T T T T T T T T T T T T T
T T T T T T T T T T T T T T T T T T T T T T T T T T T T T T T T T T T T T T T T T T T T T T T T T T T T T T T T T T T T T T T T T T T T T T T T T T T T T T T T T T T T T T T T T T T T T T T T T T T T T T T T T T T T T T T T T T T T T T T T T T T T T T T T T T T T T
T T T T T T T T T T T T T T T T T T T T T T T T T T T T T T T T T T T T T T T T T T T T T T T T T T T T T T T T T T T T T T T T T T T T T T T T T T T T T T T T T T T T T T T T T T T T T T T T T T T T T T T T T T T T T T T T T T T T T T T T T T T T T T T T T T T T T
T T T T T T T T T T T T T T T T T T T T T T T T T T T T T T T T T T T T T T T T T T T T T T T T T T T T T T T T T T T T T T T T T T T T T T T T T T T T T T T T T T T T T T T T T T T T T T T T T T T T T T T T T T T T T T T T T T T T T T T T T T T T T T T T T T T T T
T T T T T T T T T T T T T T T T T T T T T T T T T T T T T T T T T T T T T T T T T T T T T T T T T T T T T T T T T T T T T T T T T T T T T T T T T T T T T T T T T T T T T T T T T T T T T T T T T T T T T T T T T T T T T T T T T T T T T T T T T T T T T T T T T T T T T
T T T T T T T T T T T T T T T T T T T T T T T T T T T T T T T T T T T T T T T T T T T T T T T T T T T T T T T T T T T T T T T T T T T T T T T T T T T T T T T T T T T T T T T T T T T T T T T T T T T T T T T T T T T T T T T T T T T T T T T T T T T T T T T T T T T T T
T T T T T T T T T T T T T T T T T T T T T T T T T T T T T T T T T T T T T T T T T T T T T T T T T T T T T T T T T T T T T T T T T T T T T T T T T T T T T T T T T T T T T T T T T T T T T T T T T T T T T T T T T T T T T T T T T T T T T T T T T T T T T T T T T T T T T
T T T T T T T T T T T T T T T T T T T T T T T T T T T T T T T T T T T T T T T T T T T T T T T T T T T T T T T T T T T T T T T T T T T T T T T T T T T T T T T T T T T T T T T T T T T T T T T T T T T T T T T T T T T T T T T T T T T T T T T T T T T T T T T T T T T T T
T T T T T T T T T T T T T T T T T T T T T T T T T T T T T T T T T T T T T T T T T T T T T T T T T T T T T T T T T T T T T T T T T T T T T T T T T T T T T T T T T T T T T T T T T T T T T T T T T T T T T T T T T T T T T T T T T T T T T T T T T T T T T T T T T T T T T
T T T T T T T T T T T T T T T T T T T T T T T T T T T T T T T T T T T T T T T T T T T T T T T T T T T T T T T T T T T T T T T T T T T T T T T T T T T T T T T T T T T T T T T T T T T T T T T T T T T T T T T T T T T T T T T T T T T T T T T T T T T T T T T T T T T T T
T T T T T T T T T T T T T T T T T T T T T T T T T T T T T T T T T T T T T T T T T T T T T T T T T T T T T T T T T T T T T T T T T T T T T T T T T T T T T T T T T T T T T T T T T T T T T T T T T T T T T T T T T T T T T T T T T T T T T T T T T T T T T T T T T T T T T
T T T T T T T T T T T T T T T T T T T T T T T T T T T T T T T T T T T T T T T T T T T T T T T T T T T T T T T T T T T T T T T T T T T T T T T T T T T T T T T T T T T T T T T T T T T T T T T T T T T T T T T T T T T T T T T T T T T T T T T T T T T T T T T T T T T T T
T T T T T T T T T T T T T T T T T T T T T T T T T T T T T T T T T T T T T T T T T T T T T T T T T T T T T T T T T T T T T T T T T T T T T T T T T T T T T T T T T T T T T T T T T T T T T T T T T T T T T T T T T T T T T T T T T T T T T T T T T T T T T T T T T T T T T
T T T T T T T T T T T T T T T T T T T T T T T T T T T T T T T T T T T T T T T T T T T T T T T T T T T T T T T T T T T T T T T T T T T T T T T T T T T T T T T T T T T T T T T T T T T T T T T T T T T T T T T T T T T T T T T T T T T T T T T T T T T T T T T T T T T T T
